%%%%%%%%%%
%P       %
% %.%%%. %
% % %.   %
% %.% %. %
%.      G%
%%%%%%%%%%
